NO ./imgs/wall.xpm
SO ./imgs/wall.xpm
WE ./imgs/wall.xpm
EA ./imgs/wall.xpm

F 50,50,50
C 255,255,255

1111111111111111111111111
10S0000000020000000000001111111111111
1111111111111000000000000000000000001
1011000001110000000000001111111111111
1001000000000000000000001
1001000000000000000000001
1111111111111111111111111
