NO ./imgs/wall_n.xpm
SO ./imgs/wall_s.xpm
WE ./imgs/wall_w.xpm
EA ./imgs/wall_e.xpm

F 50,50,50
C 255,255,255

                     1111111111111           111111111111111
             11111111110S00000000111111111111101111111111111
1111111111111100000000000000000000001111111111
101100000111000000000000111111111111111111
1001000000000000000000001
1001000000000000000000001
1111111111111111111111111
