NO                  ./imgs/wall.xpm
C                           10                   ,                                    255                        , 2          

SO                   ./imgs/wall.xpm







EA                     ./imgs/wall.xpm




F 100,100,100


WE                    ./imgs/wall.xpm






                     1111111111111           111111111111111
             11111111110000000000111111111111101111111111111
11111111111111000000002200000000000011111111111
1S1100000111000000000000111111111111111111
1001000000000000000000001
1001000000000000000000001
1111111111111111111111111
