NO ./imgs/wall.xpm
SO ./imgs/wall.xpm
WE ./imgs/wall.xpm
EA ./imgs/wall.xpm

F 100,100,100
C 50,50,50

                     1111111111111           111111111111111
             11111111110S00000000111111111111101111111111111
111111111111110000000022000000000200111111111111
101100000111000000000000111111111111111111
1001000000000000000000001
1001000000000000000000001
1111111111111111111111111