NO ./imgs/no_redbrick.xpm
SO ./imgs/so_redbrick.xpm
WE ./imgs/we_redbrick.xpm
EA ./imgs/ea_redbrick.xpm

F 100,100,100
C 50,50,50

11111111111111
1S000000000001
10000000000001
10000000000001
10000000000001
10000000000001
11000000000001
11111111111111