NO ./imgs/wall_last.xpm
SO ./imgs/wall_last.xpm
WE ./imgs/wall_last.xpm
EA ./imgs/wall_last.xpm

F 100,100,100
C 50,50,50

11111111111111
1E000000000011
10000000000001
10000012100001
10000000000001
1000000000F001
10000000000001
11111111111111
